Country,Applied; APEDA Certified,Certified,Revoked,Surrendered,Suspended,All
All Countries,1637,45865,104,15570,4832,68008
Afghanistan,0,0,0,2,3,5
Albania,0,12,0,5,7,24
Algeria,0,13,0,3,3,19
Argentina,0,1357,1,826,13,2197
Armenia,0,24,0,14,8,46
Australia,0,538,0,90,5,633
Austria,0,7,0,1,0,8
Azerbaijan,0,6,0,0,1,7
Bahamas (The),0,2,0,0,0,2
Bahrain,0,1,0,0,0,1
Bangladesh,0,1,0,0,0,1
Belarus,0,6,0,1,1,8
Belgium,0,18,0,9,1,28
Belize,0,5,0,4,1,10
Benin,0,12,0,2,0,14
Bermuda,0,0,0,1,0,1
Bolivia (Plurinational State of),0,308,0,95,5,408
Bosnia and Herzegovina,0,20,0,7,7,34
Botswana,0,1,0,0,0,1
Brazil,0,740,0,168,103,1011
Bulgaria,0,65,0,24,3,92
Burkina Faso,0,50,0,10,3,63
Burundi,0,2,0,0,0,2
Cambodia,0,55,0,13,0,68
Cameroon,0,5,0,2,0,7
Canada,0,103,0,40,7,150
Cayman Islands (The),0,2,0,0,0,2
Chad,0,4,0,1,0,5
Chile,0,890,3,484,189,1566
China,0,1582,19,763,110,2474
Colombia,0,418,1,102,32,553
Comoros (The),0,3,0,0,1,4
Congo (The Democratic Republic of The),0,17,0,1,3,21
Costa Rica,0,99,0,40,19,158
Croatia,0,0,0,2,0,2
Cuba,0,4,0,1,5,10
Czech Republic (The),0,2,0,2,0,4
CÃ´te d'Ivoire,0,32,0,7,1,40
Dominican Republic (The),0,180,3,83,61,327
Ecuador,0,773,16,245,155,1189
Egypt,0,109,2,58,7,176
El Salvador,0,15,0,0,1,16
Estonia,0,0,0,1,0,1
Ethiopia,0,198,2,151,19,370
Fiji,0,8,0,4,0,12
France,0,47,0,15,4,66
French Polynesia,0,12,0,3,2,17
Gambia (The),0,0,0,0,1,1
Georgia,0,5,0,4,0,9
Germany,0,80,0,24,1,105
Ghana,0,51,0,14,4,69
Greece,0,21,0,7,0,28
Grenada,0,8,0,2,2,12
Guatemala,0,144,1,15,10,170
Guinea,0,2,0,0,0,2
Guinea-Bissau,0,1,0,0,0,1
Guyana,0,1,0,0,0,1
Haiti,0,5,0,0,3,8
Honduras,0,141,0,72,0,213
Hong Kong,0,9,0,6,0,15
Iceland,0,2,0,0,0,2
India,1635,639,0,84,7,2365
Indonesia,0,199,0,78,28,305
Iran (Islamic Republic of),0,24,0,25,3,52
Ireland,0,1,0,0,0,1
Israel,0,48,0,28,0,76
Italy,0,180,0,157,19,356
Jamaica,0,10,0,9,6,25
Japan,0,113,0,22,0,135
Jordan,0,7,0,1,1,9
Kazakhstan,0,5,2,17,13,37
Kenya,0,29,0,12,1,42
Korea (The Democratic People's Republic of),0,2,0,0,0,2
Korea (The Republic of),0,126,0,64,3,193
Kuwait,0,0,0,1,0,1
Kyrgyzstan,0,7,0,14,6,27
Lao People's Democratic Republic (The),0,16,0,0,2,18
Latvia,0,6,0,1,0,7
Lebanon,0,5,0,0,0,5
Lesotho,0,3,0,1,1,5
Lithuania,0,0,0,2,0,2
Madagascar,0,136,0,39,11,186
Malawi,0,3,0,2,0,5
Malaysia,0,15,0,5,2,22
Maldives,0,0,0,1,0,1
Mali,0,8,0,2,1,11
Mauritius,0,10,0,1,0,11
Mexico,0,2492,0,757,376,3625
Moldova (The Republic of),0,4,1,6,9,20
Monaco,0,2,0,0,0,2
Montenegro,0,0,0,1,0,1
Morocco,0,201,1,50,51,303
Mozambique,0,8,0,2,0,10
Myanmar,0,10,0,14,0,24
Namibia,0,16,0,6,0,22
NeTherlands (The),0,85,0,59,9,153
Nepal,0,61,0,29,8,98
New Caledonia,0,2,0,0,0,2
Nicaragua,0,96,0,24,10,130
Niger (The),0,1,0,1,0,2
Nigeria,0,22,0,7,0,29
Norway,0,0,0,1,0,1
Oman,0,0,0,1,0,1
Pakistan,0,52,0,20,3,75
"Palestine, State of",0,2,0,1,0,3
Panama,0,8,0,5,1,14
Papua New Guinea,0,17,0,3,0,20
Paraguay,0,104,0,67,14,185
Peru,0,1236,2,598,189,2025
Philippines (The),0,133,0,40,8,181
Poland,0,2,0,1,0,3
Portugal,0,2,0,2,0,4
Puerto Rico,0,2,0,0,0,2
Qatar,0,1,0,0,0,1
Romania,0,3,0,1,1,5
Russian Federation (The),0,51,3,53,17,124
Rwanda,0,21,0,9,0,30
Saint Lucia,0,1,0,0,0,1
Samoa,0,5,0,0,0,5
Sao Tome and Principe,0,1,0,1,0,2
Saudi Arabia,0,3,0,6,0,9
Senegal,0,4,0,4,2,10
Serbia,0,48,0,29,3,80
Seychelles,0,0,0,1,0,1
Sierra Leone,0,11,0,3,0,14
Singapore,0,24,0,13,4,41
Solomon Islands,0,1,0,0,0,1
Somalia,0,3,0,3,0,6
South Africa,0,216,0,83,8,307
Spain,0,83,0,39,4,126
Sri Lanka,0,284,0,75,4,363
Sudan (The),0,10,0,2,2,14
Swaziland,0,3,0,0,0,3
Sweden,0,0,0,0,1,1
Switzerland,0,12,0,1,0,13
Taiwan (Province of China),0,36,0,10,4,50
Tajikistan,0,2,0,2,0,4
"Tanzania, United Republic of",0,33,0,15,3,51
Thailand,0,305,1,185,31,522
The Republic of North Macedonia,0,2,0,5,0,7
Timor-Leste,0,4,0,0,0,4
Togo,0,44,0,7,0,51
Tonga,0,0,0,1,0,1
Trinidad and Tobago,0,7,0,1,0,8
Tunisia,0,401,6,134,63,604
Turkey,0,830,5,509,85,1429
Uganda,0,101,0,34,4,139
Ukraine,0,73,7,49,8,137
United Arab Emirates (The),0,19,1,21,6,47
United Kingdom of Great Britain and NorThern Ireland (The),0,10,0,1,0,11
United States Minor Outlying Islands (The),0,1,0,0,1,2
United States of America (The),0,23853,21,7068,2167,33109
Uruguay,0,50,0,26,5,81
Uzbekistan,0,32,3,10,5,50
Vanuatu,0,4,0,2,0,6
Venezuela (Bolivarian Republic of),0,1,0,1,0,2
Viet Nam,0,150,1,92,15,258
Virgin Islands (U.S.),0,1,0,1,0,2
Zambia,0,6,0,5,0,11
Zimbabwe,0,9,0,3,0,12
No Country Name,2,4740,2,1380,806,6930
